Gg, Gg, Gg, Gg, Gg, Gg, Gg, Gg, Gg, Gg, Gg, Gg, Gs^Fp, Gs^Fp, Hh, Hh, Gs^Fp, Gg, Gg, Gg, Rr, Gg, Gg, Gg, Gg, Gg, Gs^Fp, Gs^Fp, Gs^Fp, Gs^Fp
Gg, Gg, Gg, Gg, Gg, Gg, Gg^Vh, Gg, Re^Gvs, Gg, Gg, Gg, Gs^Fp, Gs^Fp, Hh, Gs^Fp, Gg, Gs^Fp, Gg, Gg, Rr, Gg, Gg, Gg, Gg, Gg, Gg, Gg, Gg, Gs^Fp
Gs^Fp, Gs^Fp, Gg, Gg, Gg, Gg, Re^Gvs, Re^Gvs, Re^Gvs, Re^Gvs, Re^Gvs, Gg, Gg, Gs^Fp, Gs^Fp, Gs^Fp, Gs^Fp, Gg, Rr, Rr, Gg, Gg, Re^Gvs, Re^Gvs, Re^Gvs, Gg^Vh, Gg, Gg, Gs^Fp, Gs^Fp
Gs^Fp, Hh, Hh, Gs^Fp, Gg, Re^Gvs, Re^Gvs, Re^Gvs, Re^Gvs, Re^Gvs, Gg, Gg^Vh, Gg, Gg, Gg, Gg, Gg, Gg, Rr, Gg, Re^Gvs, Re^Gvs, Re^Gvs, Re^Gvs, Re^Gvs, Re^Gvs, Gg, Gg, Gs^Fp, Hh
Gg, Gs^Fp, Gs^Fp, Gs^Fp, Gg, Gg, Gg^Vh, Re^Gvs, Gg, Gg, Rr, Gg, Rr, Gg, Gg, Gg, Gg, Gg, Rr, Gg, Gg^Vh, Re^Gvs, Re^Gvs, Re^Gvs, Gg, Gg, Gg, Gs^Fp, Gg, Gs^Fp
Gg, Gg, Gg, Gg, Gg, Gg, Gg, Gg, Rr, Rr, Gg, Rr, Gg, Rr, Rr, Rr, Ch, Rr, Rr, Gg, Gg, Gg, Gg, Gg, Gg, Gg, Gg, Gg, Gg, Gs^Fp
Gg, Gg, Gg, Ce, Gg, Gg, Rr, Rr, Gg, Gg, Re^Gvs, Gg, Gg^Vh, Gg, Rr, Ch, Kh, Rr, Ch, Gg, Gg, Gg, Re^Gvs, Gg, Gg, Gg, Gg, Ce, Gg, Gg
Gg, Gg, Gg, Gg, Gg, Gg, Rr, Gg, Re^Gvs, Re^Gvs, Re^Gvs, Re^Gvs, Gg, Gg, Ch, Rr, Ch, Rr, Gg, Gg, Re^Gvs, Re^Gvs, Re^Gvs, Re^Gvs, Re^Gvs, Gg^Vh, Gg, Gg, Gg, Gg
Gs^Fp, Gg, Gg, Ce, Ce, Ket, Gg, Gg, Gg, Re^Gvs, Gg, Gg, Gg, Gg, Gg, Rr, Gg, Rr, Rr, Gg, Gg, Re^Gvs, Re^Gvs, Re^Gvs, Re^Gvs, Re^Gvs, Gg, Ce, Gg, Gg
Gs^Fp, Gg, Gs^Fp, Gg, Gg, Ce, Ce, Gg, Gs^Fp, Gg, Gs^Fp, Gg, Re^Gvs, Re^Gvs, Re^Gvs, Gg, Gg^Vh, Gg, Gg, Rr, Rr, Gg, Gg, Re^Gvs, Gg, Gg, Gg, Gg, Gs^Fp, Gs^Fp
Hh, Hh, Gs^Fp, Gg, Re, Gg, Gg, Gg, Gs^Fp, Gs^Fp, Gs^Fp, Gg, Gg, Re^Gvs, Re^Gvs, Re^Gvs, Gg, Gg, Ce, Gg, Rr, Gg, Ce, Gg, Gs^Fp, Gg, Gs^Fp, Gg, Gs^Fp, Gs^Fp
Gg, Hh, Gg, Gg, Re, Gg, Gs^Fp, Gs^Fp, Hh, Hh, Hh, Gg, Gs^Fp, Gg, Gg, Gg, Gs^Fp, Gg, Gg, Ce, Gg, Ce, Gg, Gg, Gs^Fp, Gs^Fp, Hh, Gs^Fp, Hh, Hh
Gg, Gs^Fp, Gg, Gg^Fp, Re, Gg, Gg, Gs^Fp, Gs^Fp, Gs^Fp, Hh, Gs^Fp, Hh, Gg, Gs^Fp, Gg, Gs^Fp, Gg, Gg, Gg, Re, Gg, Gg, Gs^Fp, Gs^Fp, Hh, Gg, Hh, Gs^Fp, Gg
Gg, Gg, Gg, Gg, Re, Gg, Gs^Fp, Gs^Fp, Gg, Gs^Fp, Gg, Hh, Gs^Fp, Gs^Fp, Hh, Gs^Fp, Gs^Fp, Gs^Fp, Gg, Gg, Re, Gg, Gs^Fp, Gg, Gs^Fp, Gs^Fp, Gg, Gs^Fp, Gg, Gg
Gg, Gg, Gg, Gg^Vh, Re, Gg, Gg, Gs^Fp, Gg, Gs^Fp, Gg, Hh, Gg, Gs^Fp, Gg, Hh, Gs^Fp, Gg, Gg, Gg^Vh, Re, Gg, Gg, Gg, Gg, Gs^Fp, Gg, Gg, Ss, Ss
Gg, Gg, Gg, Gg, Gg, Re, Gg, Gg, Gg, Gg, Gg, Gg, Gg, Gg, Gg, Gs^Fp, Gg, Gs^Fp, Gg, Gg, Re, Gg, Gg, Ss, Ss, Gg, Ss, Gg, Ss, Gg
Ww, Ww, Ww, Gg, Ww, Gg, Rb, Rb, Gg, Gg, Gg, Gg, Gg, Gg, Gg, Gg, Gg, Gg, Re, Re, Gg, Gg, Ss, Ss, Ss, Ss, Ss, Ss, Ss, Gg
Ww, Ww, Ww, Ww, Ww, Ww, Wwf, Wwf, Ww, Ww, Ww, Gg, Ww, Gg, Gg, Rb, Rb, Gg, Gg, Gg, Gg, Gg, Ss, Ss, Ww, Ss, Ss, Ss, Ww, Ww
Gg, Gg, Gg, Gg, Gg, Gg, Rb, Rb, Gg, Ww, Gg, Ww, Ww, Ww, Ww, Wwf, Wwf, Gg, Ww, Gg, Gg, Ss, Ss, Ww, Ww, Ss, Ww, Ss, Ww, Ss
Gg, Gs^Fp, Gs^Fp, Gg, Gg, Gg, Gg, Rb, Rb, Gg, Rb, Gg, Gg, Gg, Rb, Rb, Rb, Ww, Ww, Ww, Ww, Ww, Ww, Ww, Ww, Ww, Ww, Ss, Ww, Ww
Gs^Fp, Gs^Fp, Gs^Fp, Gg, Gs^Fp, Gg, Gg, Rb, Cer, Cer, Cer, Rb, Rb, Rb, Gg, Gg, Gg, Gg, Gg, Gg, Gg, Ww, Ss, Ss, Ww, Ss, Ww, Ww, Ww, Ww
Gs^Fp, Gs^Fp, Gs^Fp, Gs^Fp, Gs^Fp, Gs^Fp, Gs^Fp, Gg, Rb, Ker, Rb, Gg, Gg, Gs^Fp, Gs^Fp, Gs^Fp, Gs^Fp, Gg, Gs^Fp, Gg, Gs^Fp, Gg, Gg, Ss, Ss, Ss, Ss, Ss, Ss, Ss
Gs^Fp, Gs^Fp, Gs^Fp, Gg, Gg, Gg, Gg, Gg, Cer, Cer, Gg, Gg, Gs^Fp, Gg, Gs^Fp, Gs^Fp, Gs^Fp, Gg, Gs^Fp, Gg, Gs^Fp, Gs^Fp, Gg, Gg, Gg, Ss, Gg, Gg, Gg, Ss
Gs^Fp, Gs^Fp, Gs^Fp, Gs^Fp, Gs^Fp, Gg, Gs^Fp, Gg, Gg, Rb, Gg, Gs^Fp, Gs^Fp, Gg, Gs^Fp, Gs^Fp, Gs^Fp, Gs^Fp, Gs^Fp, Gs^Fp, Gs^Fp, Gg, Gs^Fp, Gg, Gs^Fp, Gg, Gg, Gs^Fp, Gs^Fp, Gs^Fp
Gs^Fp, Gs^Fp, Gs^Fp, Gs^Fp, Gg, Gs^Fp, Gg, Gs^Fp, Gg, Rb, Rb, Gg, Gs^Fp, Gs^Fp, Gs^Fp, Gs^Fp, Gs^Fp, Gg, Gg, Gg, Gg, Gs^Fp, Gg, Gs^Fp, Gs^Fp, Gs^Fp, Gs^Fp, Gs^Fp, Gs^Fp, Gs^Fp
