Hh, Hh, Gs^Fp, Gs^Fp, Gg, Gg, Gg, Gs^Fp, Gs^Fp, Gg, Gg, Rb, Gg, Gg, Gg, Gg, Gs^Fp, Gs^Fp, Gs^Fp, Gg, Gg, Gg, Ww, Gg, Gg, Gs^Fp, Gs^Fp
Hh, Hh, Hh, Gs^Fp, Gs^Fp, Gs^Fp, Gs^Fp, Gg, Gs^Fp, Gg, Gg, Rb, Gg, Gg, Gs^Fp, Gg, Gg, Gs^Fp, Gs^Fp, Gs^Fp, Gg, Gg, Ww, Ss, Gg, Gs^Fp, Gs^Fp
Gs^Fp, Gs^Fp, Gs^Fp, Gs^Fp, Gs^Fp, Gs^Fp, Gs^Fp, Gs^Fp, Gs^Fp, Gs^Fp, Gs^Fp, Rb, Rb, Gs^Fp, Gs^Fp, Gs^Fp, Gg, Gs^Fp, Gs^Fp, Gg, Gg, Ss, Ww, Ss, Ss, Gg, Gs^Fp
Gs^Fp, Gs^Fp, Gs^Fp, Gg, Gs^Fp, Gg^Vhr, Gg, Gs^Fp, Gs^Fp, Gs^Fp, Gs^Fp, Rb, Gg, Rb, Gs^Fp, Gs^Fp, Gg, Gg^Vhr, Gs^Fp, Gs^Fp, Gg, Ss, Ss, Ww, Ss, Gg, Gg
Hh, Hh, Hh, Hh, Gg, Gg, Gs^Fp, Gs^Fp, Gs^Fp, Gs^Fp, Rb, Gs^Fp, Gs^Fp, Rb, Gs^Fp, Gs^Fp, Gg, Gs^Fp, Gs^Fp, Gs^Fp, Gg, Gg, Ss, Ww, Ww, Ss, Gg
Gg, Hh, Hh, Gs^Fp, Gs^Fp, Gs^Fp, Gg, Gs^Fp, Rb, Rb, Gs^Fp, Gs^Fp, Gs^Fp, Gs^Fp, Rb, Gs^Fp, Gs^Fp, Gs^Fp, Gg, Gs^Fp, Gg, Gg, Chs, Ss, Ww, Ss, Ss
Gg, Gs^Fp, Hh, Hh, Gs^Fp, Gg, Rb, Rb, Gg, Gs^Fp, Gs^Fp, Gs^Fp, Gs^Fp, Gg, Rb, Gs^Fp, Rb, Rb, Rb, Gg, Ss, Ss, Ss, Ss, Ww, Ww, Ss
Gg, Gs^Fp, Gs^Fp, Gs^Fp, Gg, Gs^Fp, Rb, Gs^Fp, Gs^Fp, Gs^Fp, Gs^Fp, Chr, Gs^Fp, Gs^Fp, Rb, Gs^Fp, Rb, Gs^Fp, Rb, Chr, Khs, Chs, Ss, Ww, Ww, Ss, Ss
Gs^Fp, Gs^Fp, Gg, Gg, Gs^Fp, Gs^Fp, Gs^Fp, Rb, Gs^Fp, Gg, Gs^Fp, Gs^Fp, Gs^Fp, Rb, Gs^Fp, Gs^Fp, Rb, Gs^Fp, Gs^Fp, Rb, Gg, Chs, Ss, Ss, Ss, Ww, Ss
Gs^Fp, Gs^Fp, Gs^Fp, Gs^Fp, Gs^Fp, Gs^Fp, Rb, Rb, Gs^Fp, Gs^Fp, Gs^Fp, Rb, Rb, Rb, Gs^Fp, Gs^Fp, Gs^Fp, Gs^Fp, Gs^Fp, Gg, Gg, Ss, Ss, Ww, Ww, Ww, Ss
Gs^Fp, Gg, Gg, Gg, Gs^Fp, Gs^Fp, Gs^Fp, Gs^Fp, Gs^Fp, Rb, Gs^Fp, Gs^Fp, Gs^Fp, Gs^Fp, Hh, Hh, Gs^Fp, Rb, Gs^Fp, Gs^Fp, Gg, Gg, Gg, Ss, Ww, Ss, Ss
Gs^Fp, Gs^Fp, Gs^Fp, Gg^Vhr, Gg, Gs^Fp, Rb, Gg, Rb, Rb, Gs^Fp, Hh, Hh, Hh, Chr, Hh, Gs^Fp, Rb, Rb, Gs^Fp, Gs^Fp, Gs^Fp, Gg, Ss, Ss, Ww, Ss
Gs^Fp, Gg, Gg, Gg, Gs^Fp, Gs^Fp, Gs^Fp, Rb, Gs^Fp, Gs^Fp, Gs^Fp, Gs^Fp, Gs^Fp, Gs^Fp, Gs^Fp, Gs^Fp, Gs^Fp, Gs^Fp, Rb, Gs^Fp, Gs^Fp, Gg, Gs^Fp, Gg, Ss, Ww, Gg
Gg, Gs^Fp, Gg, Gs^Fp, Gs^Fp, Rb, Gg, Gs^Fp, Gs^Fp, Gg, Chr, Gs^Fp, Gs^Fp, Gs^Fp, Gs^Fp, Gg, Gs^Fp, Rb, Gs^Fp, Gs^Fp, Gs^Fp, Gg^Vhr, Gs^Fp, Gg, Ww, Ww, Gg
Gs^Fp, Gs^Fp, Gs^Fp, Gs^Fp, Rb, Rb, Gg, Gs^Fp, Gs^Fp, Gs^Fp, Gs^Fp, Gs^Fp, Gs^Fp, Gg, Gs^Fp, Gg, Rb, Gs^Fp, Gs^Fp, Rb, Rb, Gs^Fp, Gs^Fp, Gg, Ww, Gg, Gs^Fp
Gs^Fp, Gs^Fp, Gg, Gg, Khr, Chr, Rb, Gg, Gs^Fp, Gs^Fp, Gs^Fp, Gg, Gs^Fp, Gg, Gs^Fp, Rb, Gs^Fp, Gs^Fp, Gg, Gs^Fp, Gs^Fp, Gs^Fp, Gg, Gg, Ww, Gg, Gg
Gs^Fp, Gs^Fp, Gg, Chr, Chr, Gg, Gs^Fp, Rb, Rb, Rb, Rb, Gs^Fp, Gs^Fp, Rb, Gs^Fp, Gs^Fp, Rb, Gs^Fp, Gg, Gs^Fp, Rb, Gs^Fp, Gs^Fp, Gg, Ww, Ww, Gg
Gs^Fp, Gs^Fp, Gs^Fp, Gg, Gg, Gg, Gs^Fp, Gs^Fp, Gg, Gs^Fp, Rb, Gs^Fp, Gg^Vhr, Rb, Gs^Fp, Rb, Gs^Fp, Rb, Rb, Rb, Gg, Gs^Fp, Gs^Fp, Gg, Gg, Ww, Ww
Gs^Fp, Gs^Fp, Gs^Fp, Gs^Fp, Gs^Fp, Gs^Fp, Chr, Gs^Fp, Gs^Fp, Gs^Fp, Gs^Fp, Rb, Rb, Rb, Gs^Fp, Rb, Rb, Gs^Fp, Gs^Fp, Gs^Fp, Gs^Fp, Gs^Fp, Hh, Gs^Fp, Gg, Ww, Ww
Gg, Hh, Hh, Hh, Gs^Fp, Gs^Fp, Gs^Fp, Gs^Fp, Gs^Fp, Gs^Fp, Gg, Gs^Fp, Rb, Gg, Gs^Fp, Gs^Fp, Rb, Gg, Gs^Fp, Gs^Fp, Gg^Vhr, Hh, Gs^Fp, Gs^Fp, Gg, Gg, Ww
Hh, Gs^Fp, Hh, Hh, Gs^Fp, Gs^Fp, Gs^Fp, Gs^Fp, Gg, Gs^Fp, Rb, Gs^Fp, Gs^Fp, Gs^Fp, Rb, Gs^Fp, Gs^Fp, Gs^Fp, Hh, Hh, Hh, Hh, Hh, Gs^Fp, Gs^Fp, Gg, Ww
Gs^Fp, Hh, Hh, Hh, Hh, Gs^Fp, Gs^Fp, Gs^Fp, Gs^Fp, Rb, Gg, Gs^Fp, Gs^Fp, Gs^Fp, Rb, Gg, Gs^Fp, Gs^Fp, Gs^Fp, Hh, Hh, Gs^Fp, Gs^Fp, Gs^Fp, Gg, Gg, Ww
Gs^Fp, Hh, Hh, Gs^Fp, Gs^Fp, Gs^Fp, Gs^Fp, Gs^Fp, Gs^Fp, Rb, Gs^Fp, Gs^Fp, Gs^Fp, Gs^Fp, Gs^Fp, Rb, Gs^Fp, Gs^Fp, Gg, Gs^Fp, Hh, Hh, Gs^Fp, Gs^Fp, Gg, Gg, Ww
Gg, Gs^Fp, Hh, Gs^Fp, Gs^Fp, Gs^Fp, Gs^Fp, Gs^Fp, Rb, Gs^Fp, Gs^Fp, Gs^Fp, Gs^Fp, Gs^Fp, Gs^Fp, Gs^Fp, Rb, Gs^Fp, Gs^Fp, Gs^Fp, Gs^Fp, Gs^Fp, Gg, Gg, Ss, Ww, Ww
Gs^Fp, Hh, Hh, Gg, Gs^Fp, Gs^Fp, Gg, Gs^Fp, Rb, Gs^Fp, Gs^Fp, Gs^Fp, Gs^Fp, Gs^Fp, Gs^Fp, Gs^Fp, Rb, Gs^Fp, Gs^Fp, Gg, Gg, Gg, Gg, Ss, Ww, Ww, Gg
Gs^Fp, Gs^Fp, Hh, Hh, Gs^Fp, Gs^Fp, Gg, Gg, Rb, Gg, Gg, Gg, Gs^Fp, Gg, Gg, Gg, Rb, Gs^Fp, Gg, Gs^Fp, Gg, Ss, Ss, Ss, Ww, Ss, Gg
Gs^Fp, Gs^Fp, Hh, Hh, Gs^Fp, Gs^Fp, Gs^Fp, Gg, Gg, Re, Re, Gg, Re, Gg, Re, Re, Gg, Gs^Fp, Gg, Gg, Ss, Ss, Ww, Ww, Ss, Ss, Gg
Gs^Fp, Hh, Hh, Gg, Gs^Fp, Gg, Gs^Fp, Gs^Fp, Gg, Gg, Re, Ce, Ket, Ce, Ce, Gg, Gg, Gg, Gg, Gg, Ss, Ss, Ww, Ww, Ss, Gg, Gs^Fp
Hh, Hh, Hh, Gs^Fp, Hh, Gg, Gg, Gg, Gg, Re^Vct, Ce, Ce, Ce, Re, Re^Vct, Gg, Gg, Gs^Fp, Gg, Ss, Ss, Ss, Ww, Ss, Gg, Gg, Gs^Fp
Hh, Gs^Fp, Hh, Hh, Gg, Gg, Gs^Fp, Gg, Gg, Gg, Gg, Re, Re, Gg, Gg, Gg, Gs^Fp, Gg, Gg, Ss, Ss, Ww, Ss, Ss, Ss, Gg, Gg
Gs^Fp, Hh, Gg, Hh, Gg, Gs^Fp, Gs^Fp, Gg, Gs^Fp, Gg, Gg, Re, Gg, Gg, Gg, Gg, Gs^Fp, Gs^Fp, Gg, Ss, Ww, Ww, Ss, Ss, Gg, Gg, Gs^Fp
Gg, Gs^Fp, Gs^Fp, Gg, Gs^Fp, Gs^Fp, Gs^Fp, Gs^Fp, Gs^Fp, Gg, Gg, Re, Gg, Gg, Gg, Gs^Fp, Gs^Fp, Gs^Fp, Gg, Ss, Ww, Ww, Gg, Ss, Gg, Gs^Fp, Gs^Fp
