Hh, Hh, Hh, Hh, Mm, Hh, Hh, Hh, Hh, Ss, Gs^Fp, Gs^Fp, Gs^Fp, Gg, Gg, Ss, Ss, Gg, Gg, Gs^Fp, Gs^Fp, Gs^Fp, Gs^Fp, Gg, Hh, Hh, Mm, Mm, Mm, Hh, Hh, Hh
Hh, Mm, Hh, Hh, Hh, Hh, Hh, Gs^Fp, Hh, Hh, Gs^Fp, Gs^Fp, Gg, Gg, Ss, Ss^Vhs, Ww, Ss, Ss, Gg, Rb, Gg, Gs^Fp, Hh, Hh, Hh, Hh, Mm, Hh, Hh, Mm, Hh
Mm, Hh, Hh, Hh, Gs^Fp, Gs^Fp, Gs^Fp, Gs^Fp, Gs^Fp, Hh, Gs^Fp, Gs^Fp, Rb, Gg, Ss, Ss, Ss, Ss, Ss^Bw/r, Rb, Gg, Rb, Gs^Fp, Hh, Gs^Fp, Gs^Fp, Hh, Hh, Hh, Mm, Mm, Mm
Hh, Hh, Hh, Hh, Gs^Fp, Gs^Fp, Gs^Fp, Gs^Fp, Gs^Fp, Gs^Fp, Gs^Fp, Rb, Gg, Ss^Bw\r, Chs, Chs, Khs, Chs, Ss, Ss, Ss, Rb, Rb, Gs^Fp, Gs^Fp, Gs^Fp, Gs^Fp, Gs^Fp, Hh, Hh, Hh, Hh
Hh, Hh, Hh, Gs^Fp, Hh, Gs^Fp, Gs^Fp, Gs^Fp, Gg, Gs^Fp, Rb, Rb, Ss, Ss, Chs, Chs, Chs, Ss, Ww, Ss^Vhs, Ss, Gg, Rb, Gg, Gs^Fp, Gs^Fp, Gs^Fp, Gs^Fp, Hh, Hh, Hh, Hh
Mm, Mm, Mm, Hh, Gs^Fp, Gs^Fp, Gs^Fp, Gs^Fp, Gs^Fp, Gg, Rb, Gg, Rb, Ss^Bw/r, Ss, Ss, Ss, Ss, Ww, Ss, Gg, Rb, Gg, Gs^Fp, Gs^Fp, Gs^Fp, Gs^Fp, Gs^Fp, Hh, Hh, Mm, Hh
Hh, Mm, Hh, Hh, Hh, Gs^Fp, Hh, Gs^Fp, Gs^Fp, Gs^Fp, Gg, Rb, Gg, Ss, Ss^Vhs, Ww, Ss, Ss^Vhs, Ss, Ss, Gg, Rb, Gg, Gs^Fp, Gs^Fp, Hh, Hh, Hh, Mm, Mm, Mm, Mm
Hh, Hh, Hh, Hh, Mm, Hh, Hh, Hh, Gs^Fp, Gs^Fp, Gs^Fp, Rb, Chs, Ss, Ss, Ss, Ss, Ww, Ww, Ss, Chs, Rb, Gs^Fp, Gs^Fp, Gs^Fp, Gs^Fp, Hh, Mm, Mm, Mm, Hh, Hh
Hh, Hh, Mm, Mm, Mm, Mm, Hh, Gs^Fp, Gs^Fp, Gs^Fp, Gg, Gg, Rb, Gg, Chs, Gg, Gg, Ss, Ww, Ww, Gg, Gg, Gs^Fp, Hh, Hh, Hh, Hh, Hh, Hh, Hh, Hh, Hh
Hh, Mm, Mm, Mm, Hh, Hh, Gs^Fp, Gs^Fp, Gs^Fp, Gs^Fp, Gs^Fp, Gg, Gs^Fp, Rb, Rb, Gg, Chs, Ss, Gg, Ww, Ww, Gg, Gg, Gs^Fp, Hh, Hh, Hh, Hh, Mm, Hh, Hh, Hh
Hh, Hh, Hh, Mm, Mm, Hh, Hh, Gs^Fp, Gs^Fp, Gs^Fp, Gs^Fp, Gs^Fp, Gs^Fp, Gs^Fp, Rb, Rb, Gg, Gg, Gg, Ww, Ww, Gg, Gs^Fp, Gs^Fp, Gs^Fp, Gs^Fp, Hh, Hh, Hh, Mm, Mm, Hh
Hh, Hh, Hh, Hh, Hh, Mm, Hh, Gs^Fp, Hh, Hh, Hh, Gs^Fp, Gg, Gg, Rb, Gg, Gg, Gg, Ss, Ww, Gg, Gg, Gs^Fp, Gs^Fp, Gs^Fp, Gs^Fp, Gs^Fp, Gs^Fp, Hh, Hh, Hh, Hh
Hh, Hh, Mm, Mm, Mm, Hh, Hh, Hh, Hh, Hh, Hh, Gs^Fp, Rb, Rb, Ss, Ss, Ss, Ww, Ww, Ww, Gg, Gg, Gs^Fp, Hh, Hh, Hh, Gs^Fp, Hh, Mm, Mm, Mm, Hh
Mm, Mm, Mm, Mm, Hh, Hh, Mm, Hh, Hh, Gs^Fp, Gs^Fp, Gs^Fp, Rb, Gg, Ss^Vhs, Ww, Ww, Ww, Gg, Gg, Gs^Fp, Gs^Fp, Hh, Gs^Fp, Hh, Hh, Mm, Hh, Hh, Mm, Hh, Hh
Hh, Mm, Hh, Hh, Hh, Hh, Hh, Hh, Gs^Fp, Gs^Fp, Gs^Fp, Rb, Gg, Ss, Ww, Ss, Ww, Ss, Gg, Gg, Gs^Fp, Hh, Hh, Hh, Mm, Mm, Mm, Mm, Mm, Hh, Hh, Hh
Hh, Hh, Hh, Hh, Hh, Hh, Gs^Fp, Hh, Gs^Fp, Gs^Fp, Gg, Rb, Rb, Ss, Ww, Ss, Ss^Vhs, Ss, Gg, Gg, Gs^Fp, Gs^Fp, Hh, Hh, Hh, Mm, Hh, Hh, Hh, Hh, Hh, Hh
Hh, Hh, Mm, Mm, Mm, Hh, Hh, Gs^Fp, Hh, Gs^Fp, Gs^Fp, Gg, Gg, Chs, Ss, Ww, Ss, Gg, Gg, Gs^Fp, Gs^Fp, Hh, Gs^Fp, Hh, Hh, Gs^Fp, Gs^Fp, Hh, Mm, Hh, Hh, Hh
Mm, Mm, Mm, Mm, Hh, Hh, Mm, Hh, Hh, Gs^Fp, Gs^Fp, Gs^Fp, Gg, Rb, Rb, Chs, Ww, Ss, Gg, Gs^Fp, Gg, Gs^Fp, Gs^Fp, Gs^Fp, Gs^Fp, Gs^Fp, Hh, Mm, Mm, Mm, Mm, Hh
Hh, Mm, Hh, Hh, Gs^Fp, Hh, Gs^Fp, Hh, Mm, Hh, Gs^Fp, Gs^Fp, Gs^Fp, Gs^Fp, Gg, Rb, Gg, Ww, Gg, Gg, Gs^Fp, Gs^Fp, Gs^Fp, Hh, Hh, Gs^Fp, Hh, Hh, Hh, Mm, Mm, Mm
Hh, Hh, Hh, Hh, Gs^Fp, Hh, Gs^Fp, Gs^Fp, Hh, Hh, Hh, Gs^Fp, Gs^Fp, Gs^Fp, Gs^Fp, Rb, Gg, Ww, Ww, Gg, Gs^Fp, Gs^Fp, Hh, Hh, Hh, Hh, Mm, Mm, Mm, Hh, Hh, Hh
Gs^Fp, Hh, Gs^Fp, Hh, Hh, Gs^Fp, Gs^Fp, Gs^Fp, Gs^Fp, Gs^Fp, Gs^Fp, Gs^Fp, Gs^Fp, Gs^Fp, Gg, Rb, Chs, Ss, Ss, Gg, Gs^Fp, Gs^Fp, Gs^Fp, Hh, Gs^Fp, Hh, Hh, Mm, Hh, Hh, Hh, Hh
Hh, Hh, Gs^Fp, Gs^Fp, Gs^Fp, Gs^Fp, Hh, Gs^Fp, Hh, Gs^Fp, Gs^Fp, Gs^Fp, Gs^Fp, Gg, Rb, Rb, Rb, Gg, Ss^Vhs, Gg, Gg, Gs^Fp, Gs^Fp, Gs^Fp, Gs^Fp, Hh, Gs^Fp, Hh, Gs^Fp, Hh, Hh, Mm
Hh, Gs^Fp, Hh, Hh, Gs^Fp, Gs^Fp, Mm, Hh, Gs^Fp, Gs^Fp, Gs^Fp, Gs^Fp, Rb, Rb, Gs^Fp, Gs^Fp, Rb, Gg, Ww, Ss, Gg, Gg, Gs^Fp, Gs^Fp, Hh, Gs^Fp, Gs^Fp, Gs^Fp, Hh, Hh, Hh, Hh
Hh, Hh, Mm, Hh, Hh, Hh, Hh, Hh, Gs^Fp, Gs^Fp, Gs^Fp, Gs^Fp, Rb, Gs^Fp, Gs^Fp, Gs^Fp, Rb, Ss, Ww, Gg, Gg, Gs^Fp, Gs^Fp, Gs^Fp, Hh, Gs^Fp, Hh, Gs^Fp, Hh, Hh, Mm, Hh
Mm, Hh, Hh, Mm, Mm, Hh, Gs^Fp, Hh, Gs^Fp, Gs^Fp, Gs^Fp, Gg, Gs^Fp, Gs^Fp, Gs^Fp, Gs^Fp, Rb, Ww, Ww, Gg, Gg, Gs^Fp, Gs^Fp, Hh, Hh, Mm, Hh, Hh, Mm, Mm, Mm, Hh
Hh, Hh, Gs^Fp, Hh, Hh, Hh, Hh, Gs^Fp, Gs^Fp, Gs^Fp, Gs^Fp, Gs^Fp, Rb, Rb, Gs^Fp, Gs^Fp, Rb, Gg, Ww, Gg, Gg, Gs^Fp, Gs^Fp, Gs^Fp, Hh, Hh, Gs^Fp, Hh, Mm, Mm, Hh, Hh
Hh, Hh, Gs^Fp, Gs^Fp, Hh, Hh, Gs^Fp, Gs^Fp, Gs^Fp, Gs^Fp, Gs^Fp, Gg, Rb, Gs^Fp, Gs^Fp, Rb, Gs^Fp, Gg, Ww, Ww, Gg, Gg, Gs^Fp, Gs^Fp, Gs^Fp, Hh, Gs^Fp, Gs^Fp, Hh, Hh, Hh, Hh
Hh, Hh, Hh, Gs^Fp, Gs^Fp, Hh, Gs^Fp, Gs^Fp, Gs^Fp, Gg, Gg^Vhr, Rb, Gs^Fp, Gs^Fp, Gs^Fp, Gs^Fp, Rb, Gg, Ww, Ww, Ss, Gg, Gg, Gs^Fp, Gs^Fp, Gs^Fp, Gs^Fp, Hh, Mm, Hh, Gs^Fp, Hh
Gs^Fp, Gs^Fp, Gs^Fp, Gs^Fp, Gs^Fp, Gs^Fp, Gs^Fp, Gg, Gg, Gg, Rb, Rb, Gs^Fp, Gs^Fp, Gs^Fp, Gs^Fp, Gs^Fp, Rb, Rb, Ww, Ww, Ww, Gg, Gg, Gs^Fp, Gs^Fp, Hh, Hh, Gs^Fp, Hh, Gs^Fp, Gs^Fp
Gs^Fp, Gs^Fp, Gs^Fp, Gs^Fp, Hh, Gs^Fp, Gg, Gg, Gg^Vhr, Rb, Gg, Gs^Fp, Gs^Fp, Gs^Fp, Gs^Fp, Gs^Fp, Gs^Fp, Gs^Fp, Rb, Gg, Ss, Ww, Ss, Gg, Gg, Gs^Fp, Gs^Fp, Gs^Fp, Gs^Fp, Gs^Fp, Gs^Fp, Gs^Fp
Gs^Fp, Gs^Fp, Hh, Hh, Gs^Fp, Gs^Fp, Gs^Fp, Gs^Fp, Gg, Rb, Rb, Rb, Gs^Fp, Gs^Fp, Rb, Gg, Gs^Fp, Rb, Gs^Fp, Gg, Gg, Ww, Ss^Vhs, Ss, Gg, Gs^Fp, Gg, Gs^Fp, Gs^Fp, Hh, Mm, Hh
Gs^Fp, Gs^Fp, Hh, Hh, Gs^Fp, Gs^Fp, Gs^Fp, Gs^Fp, Gs^Fp, Gs^Fp, Gs^Fp, Gs^Fp, Gs^Fp, Rb, Gs^Fp, Rb, Gg, Gs^Fp, Gs^Fp, Gs^Fp, Gg, Ss, Ww, Ss, Ss, Gg, Gg, Gs^Fp, Hh, Hh, Hh, Hh
Gs^Fp, Gs^Fp, Hh, Gs^Fp, Hh, Gs^Fp, Hh, Hh, Hh, Hh, Hh, Hh, Gs^Fp, Gs^Fp, Re, Re, Ce, Gg, Gs^Fp, Gg, Gg, Ss, Ss, Ww, Ss, Gg, Gg, Gs^Fp, Gs^Fp, Gs^Fp, Gs^Fp, Gs^Fp
Gs^Fp, Hh, Hh, Hh, Gs^Fp, Gs^Fp, Hh, Hh, Mm, Mm, Hh, Gs^Fp, Gs^Fp, Gg, Ce, Ce, Ce, Gg, Gs^Fp, Gs^Fp, Gs^Fp, Gg, Gg, Ss, Ww, Ss, Gg, Gg, Gs^Fp, Gs^Fp, Gs^Fp, Gs^Fp
Hh, Hh, Gs^Fp, Gs^Fp, Hh, Hh, Hh, Mm, Gs^Fp, Gs^Fp, Gs^Fp, Gs^Fp, Gg, Re, Ce, Ket, Re, Gg, Gs^Fp, Gs^Fp, Gs^Fp, Gg, Gg, Ss, Ss, Ww, Ss, Gg, Gg, Gs^Fp, Hh, Gs^Fp
Hh, Hh, Hh, Gs^Fp, Hh, Mm, Hh, Hh, Hh, Gs^Fp, Gs^Fp, Gs^Fp, Gg, Re, Re, Ce, Gg, Gs^Fp, Gs^Fp, Gs^Fp, Gs^Fp, Gg, Gs^Fp, Gg, Ss, Ww, Ss, Gg, Gg, Gs^Fp, Gs^Fp, Hh
Gg, Hh, Hh, Hh, Hh, Gs^Fp, Hh, Hh, Gs^Fp, Gs^Fp, Gg, Gg, Gg, Gg, Re, Gg, Gg, Gs^Fp, Gs^Fp, Gs^Fp, Gs^Fp, Gs^Fp, Gs^Fp, Gg, Ss, Ww, Ww, Ss, Gg, Gg, Gs^Fp, Gs^Fp
